MAZE 0
0010001000
0100010010
1010011010
1010100101
0100000001
0000011101
0110000000
0010010010
0100000000
0011000000

MAZE 1
0000000000
0000001001
1001001000
1000000110
1011001000
1000000110
0000001000
1001000000
0001000011
0001000010

MAZE 2
0001100001
0100001000
1010001000
0000010000
0000011100
0101101010
0010100100
0101100001
0100000110
1000001010

MAZE 3
0100000010
0000110010
0000000100
1011110000
0101010001
0000001010
0000110100
0110100100
0000000001
1000000000

MAZE 4
0001010100
1100001000
0001010000
1001000001
0010000100
0101011001
1010100001
1010000000
1010001001
1010100010

MAZE 5
0011111000
0000001000
1100000101
0101000000
0010001010
0101101000
0001110010
0001001000
0000000000
0001100010

MAZE 6
0001100000
1100000001
0000100010
0000010000
0000001001
0010010101
1100101000
0001111100
0000000000
0010000001

MAZE 7
0110000010
0101000111
1100101001
0000101000
0100110110
1000001100
1100000001
0011100001
0001010110
0001010000

MAZE 8
0001011000
0000000010
0010000000
0110100000
0000010100
0000101001
0101001100
0100000011
0111100000
0000101101

MAZE 9
0000100000
0110000101
1001000001
1000101011
1001010010
1010100010
0001001100
0001001001
0000100000
0000000001

