MAZE 0
------------
|# #0#   ##|
|  # #     |
|   #  #   |
|##S# #    |
|# ##     #|
|  #    E  |
|# # #  # #|
|    #  #  |
|###   #  #|
|#0 #  #   |
------------

MAZE 1
------------
|  ###  #  |
|0    # #  |
|    #  #  |
|####   #  |
|# # #S ## |
|      #   |
| #  ##0# #|
|   #E###  |
|##  ## 0  |
|0 ## 0# # |
------------

MAZE 2
------------
| # 0# ### |
| # #  0   |
|  #       |
|#  # ###  |
| # 0#  ## |
|  #  #   #|
| #E##   S |
|  #      #|
| 0#  ##   |
| ##   #  #|
------------

MAZE 3
------------
|    #   # |
|  # # #   |
| #        |
|   #  #   |
|  ###   ##|
|##        |
|0## #  ###|
|#E#     #0|
|0#S## # ##|
|#0#0# # 0 |
------------

MAZE 4
------------
|    #     |
|      ##  |
|  #E# #   |
| #  ### # |
|    #S### |
|#   ##   #|
|       ## |
|# ## #    |
|#         |
|0## ### ##|
------------

